11111111111111111111
10000000000000000001
10100111001110011101
1010CC01000010000101
10100111001110000101
101000010P0010E00101
10100111001110000101
10000000000000000001
11111111111111111111