111111
1P0C01
1E0M01
10C001
111111
