1111111111
10000P0001
1000C00001
10000000E1
1111111111