1111111111111111111111111
1000000P0000000000000C001
1001110011100111001110001
1000010000100001000010001
1000010000100001000010001
1000010011100111000111001
1000010000100001000010001
1000010000100001000010001
1000010000100001000010001
1000111011100111000010001
1000000000000000C000000E1
1111111111111111111111111